1111111111111
100C100000011
10000E111C001
1P00111100001
1111111111111