1111111111111
100C100000011
1000011111001
1P0011E100001
1111111111111