1111111111111111111
11101110000P0000011
0111111111100000001
1111111111101111111