1111111111111111111
1E111110000P0000011
1111111C11100000001
1111111111111111111
