1111111111111111111
1E000000000P0000011
1110011C11100000001
1111111111111111111